C00,C00,C00,C00,C00,C00,C00,C00,C00,C00,C00,C00,C00,C00,C00,C00,C00,C00,C00,C00,C00,C00,C00,C00,C00
C00,C00,C00,C00,C00,C00,C00,C00,C00,C00,C00,C00,C00,C00,C00,C00,C00,C00,C00,C00,C00,C00,C00,C00,C00
C00,C00,C00,C00,C00,C00,C00,C00,C00,C00,C00,C00,C00,C00,C00,C00,C00,C00,C00,C00,C00,C00,C00,C00,C00
C00,C00,C00,C00,C00,C00,C00,C00,C00,C00,C00,C00,C00,C00,C00,C00,C00,C00,C00,C00,C00,C00,C00,C00,C00
C00,C00,C00,C00,C00,C00,C00,C00,C00,C00,C00,C00,C00,C00,C00,C00,C00,C00,C00,C00,C00,C00,C00,C00,C00
C00,C00,C00,C00,C00,C00,C00,C00,C00,C00,C00,C00,C00,C00,C00,C00,C00,C00,C00,C00,C00,C00,C00,C00,C00
C00,C00,C00,C00,C00,C00,C00,C00,C00,C00,C00,C00,C00,C00,C00,C00,C00,C00,C00,C00,C00,C00,C00,C00,C00
C00,C00,C00,C00,C00,C00,C00,C00,C00,C00,C00,S00,S00,S00,S00,S00,S00,S00,S00,S00,S00,S00,S00,C00,C00
C00,C00,C00,C00,C00,C00,C00,C00,C00,C00,S00,S00,S00,S00,S00,S00,S00,S00,S00,S00,S00,S00,S00,S00,C00
C00,C00,C00,C00,C00,C00,C00,C00,C00,C00,S00,S00,S00,S00,S00,S00,S00,S00,S00,S00,S00,S00,S00,S00,C00
C00,C00,C00,C00,C00,C00,C00,C00,C00,C00,S00,S00,S00,S00,S00,S00,S00,S00,S00,S00,S00,S00,S00,S00,C00
C00,C00,C00,C00,C00,C00,C00,C00,C00,C00,S00,S00,S00,S00,S00,S00,S00,S00,S00,S00,S00,S00,S00,S00,C00
C00,C00,C00,C00,C00,C00,C00,C00,C00,C00,S00,S00,S00,S00,S00,S00,S00,S00,S00,S00,S00,S00,S00,S00,C00
C00,C00,C00,C00,C00,C00,C00,C00,C00,C00,S00,S00,S00,S00,S00,S00,S00,S00,S00,S00,S00,S00,S00,C00,C00
C00,C00,C00,C00,C00,C00,C00,C00,C00,C00,S00,S00,S00,S00,S00,S00,S00,S00,S00,S00,S00,S00,C00,C00,C00
C00,C00,C00,C00,C00,C00,C00,C00,C00,C00,S00,S00,S00,S00,S00,S00,S00,S00,S00,S00,S00,C00,C00,C00,C00
C00,C00,C00,C00,C00,C00,C00,C00,C00,C00,S00,S00,S00,S00,S00,S00,S00,S00,S00,S00,S00,C00,C00,C00,C00
C00,C00,C00,C00,C00,C00,C00,C00,C00,C00,C00,S00,S00,S00,S00,S00,S00,S00,S00,S00,S00,C00,C00,C00,C00
C00,C00,C00,C00,C00,C00,C00,C00,C00,C00,C00,C00,C00,C00,C00,C00,C00,C00,C00,C00,C00,C00,C00,C00,C00
C00,C00,C00,C00,C00,C00,C00,C00,C00,C00,C00,C00,C00,C00,C00,C00,C00,C00,C00,C00,C00,C00,C00,C00,C00
C00,C00,C00,C00,C00,C00,C00,C00,C00,C00,C00,C00,C00,C00,C00,C00,C00,C00,C00,C00,C00,C00,C00,C00,C00
C00,C00,C00,C00,C00,C00,C00,C00,C00,C00,C00,C00,C00,C00,C00,C00,C00,C00,C00,C00,C00,C00,C00,C00,C00
C00,C00,C00,C00,C00,C00,C00,C00,C00,C00,C00,C00,C00,C00,C00,C00,C00,C00,C00,C00,C00,C00,C00,C00,C00
C00,C00,C00,C00,C00,C00,C00,C00,C00,C00,C00,C00,C00,C00,C00,C00,C00,C00,C00,C00,C00,C00,C00,C00,C00
C00,C00,C00,C00,C00,C00,C00,C00,C00,C00,C00,C00,C00,C00,C00,C00,C00,C00,C00,C00,C00,C00,C00,C00,C00
C00,C00,C00,C00,C00,C00,C00,C00,C00,C00,C00,C00,C00,C00,C00,C00,C00,C00,C00,C00,C00,C00,C00,C00,C00
C00,C00,C00,C00,C00,C00,C00,C00,C00,C00,C00,C00,C00,C00,C00,C00,C00,C00,C00,C00,C00,C00,C00,C00,C00
C00,C00,C00,C00,C00,C00,C00,C00,C00,C00,C00,C00,C00,C00,C00,C00,C00,C00,C00,C00,C00,C00,C00,C00,C00
C00,C00,C00,C00,C00,C00,C00,C00,C00,C00,C00,C00,C00,C00,C00,C00,C00,C00,C00,C00,C00,C00,C00,C00,C00
C00,C00,C00,C00,C00,C00,C00,C00,C00,C00,C00,C00,C00,C00,C00,C00,C00,C00,C00,C00,C00,C00,C00,C00,C00