S00,S00,S00,S00,S00,S00,S00,S00,S00,S00,S00,S00,S00,S00,S00,S00,S00,S00,S00,S00,S00,S00,S00,S00,S00
S00,S00,S00,S00,S00,S00,S00,S00,S00,S00,S00,S00,S00,S00,S00,S00,S00,S00,S00,S00,S00,S00,S00,S00,S00
S00,S00,S00,G13,G23,G23,G23,G23,G23,G23,G23,G23,G33,S00,S00,S00,S00,S00,S00,S00,S00,S00,S00,S00,S00
S00,S00,G13,G55,G24,G24,G24,G24,G24,G24,G24,G24,G45,G33,S00,S00,S00,S00,S00,S00,S00,S00,S00,S00,S00
S00,S00,G14,G24,G24,G24,G24,G24,G24,G24,G24,G24,G24,G34,S00,S00,S00,S00,S00,S00,S00,S00,S00,S00,S00
S00,S00,G14,G24,G24,G24,G24,G24,G24,G24,G24,G24,G24,G34,S00,S00,S00,S00,S00,S00,S00,S00,S00,S00,S00
S00,S00,G14,G24,G24,G24,G24,G24,G24,G24,G24,G24,G24,G34,S00,S00,S00,S00,S00,S00,S00,S00,S00,S00,S00
S00,S00,G14,G24,G24,G24,G24,G24,G24,G24,G24,G24,G44,G35,S00,S00,S00,S00,S00,S00,S00,S00,S00,S00,S00
S00,S00,G14,G24,G24,G24,G24,G24,G24,G44,G25,G25,G35,S00,S00,S00,S00,S00,S00,S00,S00,S00,S00,S00,S00
S00,S00,G14,G24,G24,G24,G24,G24,G24,G34,S00,S00,S00,S00,S00,S00,S00,S00,S00,S00,S00,S00,S00,S00,S00
S00,S00,G14,G24,G24,G24,G24,G24,G24,G34,S00,S00,S00,S00,S00,S00,S00,S00,S00,S00,S00,S00,S00,S00,S00
S00,S00,G15,G54,G24,G24,G24,G24,G24,G34,S00,S00,S00,S00,S00,S00,S00,S00,S00,S00,S00,S00,S00,S00,S00
S00,S00,S00,G15,G25,G25,G25,G25,G25,G35,S00,S00,S00,S00,S00,S00,S00,S00,S00,S00,S00,S00,S00,S00,S00
S00,S00,S00,S00,S00,S00,S00,S00,S00,S00,S00,S00,S00,S00,S00,S00,S00,S00,S00,S00,S00,S00,S00,S00,S00
S00,S00,S00,S00,S00,S00,S00,S00,S00,S00,S00,S00,S00,S00,S00,S00,S00,S00,S00,S00,S00,S00,S00,S00,S00
S00,S00,S00,S00,S00,S00,S00,S00,S00,S00,S00,S00,S00,S00,S00,S00,S00,S00,S00,S00,S00,S00,S00,S00,S00
S00,S00,S00,S00,S00,S00,S00,S00,S00,S00,S00,S00,S00,S00,S00,S00,S00,S00,S00,S00,S00,S00,S00,S00,S00
S00,S00,S00,S00,S00,S00,S00,S00,S00,S00,S00,S00,S00,S00,S00,S00,S00,S00,S00,S00,S00,S00,S00,S00,S00
S00,S00,S00,S00,S00,S00,S00,S00,S00,S00,S00,S00,S00,S00,S00,S00,S00,S00,S00,S00,S00,S00,S00,S00,S00
S00,S00,S00,S00,S00,S00,S00,S00,S00,S00,S00,S00,S00,S00,S00,S00,S00,S00,S00,S00,S00,S00,S00,S00,S00
S00,S00,S00,S00,S00,S00,S00,S00,S00,S00,S00,S00,S00,S00,S00,S00,S00,S00,S00,S00,S00,S00,S00,S00,S00
S00,S00,S00,S00,S00,S00,S00,S00,S00,S00,S00,S00,S00,S00,S00,S00,S00,S00,S00,S00,S00,S00,S00,S00,S00
S00,S00,S00,S00,S00,S00,S00,S00,S00,S00,S00,S00,S00,S00,S00,S00,S00,S00,S00,S00,S00,S00,S00,S00,S00
S00,S00,S00,S00,S00,S00,S00,S00,S00,S00,S00,S00,S00,S00,S00,S00,S00,S00,S00,S00,S00,S00,S00,S00,S00
S00,S00,S00,S00,S00,S00,S00,S00,S00,S00,S00,S00,S00,S00,S00,S00,S00,S00,S00,S00,S00,S00,S00,S00,S00
S00,S00,S00,S00,S00,S00,S00,S00,S00,S00,S00,S00,S00,S00,S00,S00,S00,S00,S00,S00,S00,S00,S00,S00,S00
S00,S00,S00,S00,S00,S00,S00,S00,S00,S00,S00,S00,S00,S00,S00,S00,S00,S00,S00,S00,S00,S00,S00,S00,S00
S00,S00,S00,S00,S00,S00,S00,S00,S00,S00,S00,S00,S00,S00,S00,S00,S00,S00,S00,S00,S00,S00,S00,S00,S00
S00,S00,S00,S00,S00,S00,S00,S00,S00,S00,S00,S00,S00,S00,S00,S00,S00,S00,S00,S00,S00,S00,S00,S00,S00
S00,S00,S00,S00,S00,S00,S00,S00,S00,S00,S00,S00,S00,S00,S00,S00,S00,S00,S00,S00,S00,S00,S00,S00,S00


