S00,S00,S00,S00,S00,S00,S00,S00,S00,S00,S00,S00,S00,S00,S00,S00,S00,S00,S00,S00,S00,S00,S00,S00,S00
S00,S00,S00,S00,S00,S00,S00,S00,S00,S00,S00,S00,S00,S00,S00,S00,S00,S00,S00,S00,S00,S00,S00,S00,S00
S00,S00,S00,S00,S00,S00,S00,S00,S00,S00,S00,S00,S00,S00,S00,S00,S00,S00,S00,S00,S00,S00,S00,S00,S00
S00,S00,S00,S00,S00,S00,S00,S00,S00,S00,S00,S00,S00,S00,S00,S00,S00,S00,S00,S00,S00,S00,S00,S00,S00
S00,S00,S00,S00,S00,S00,S00,S00,S00,S00,S00,S00,S00,S00,S00,S00,S00,S00,S00,S00,S00,S00,S00,S00,S00
S00,S00,S00,S00,S00,S00,S00,S00,S00,S00,S00,S00,S00,S00,S00,S00,S00,S00,S00,S00,S00,S00,S00,S00,S00
S00,S00,S00,S00,S00,S00,S00,S00,S00,S00,S00,S00,S00,S00,S00,S00,S00,S00,S00,S00,S00,S00,S00,S00,S00
S00,S00,S00,S00,S00,S00,S00,S00,S00,S00,S00,S00,S00,S00,S00,S00,S00,S00,S00,S00,S00,S00,S00,S00,S00
S00,S00,S00,S00,S00,S00,S00,S00,S00,S00,S00,S00,G13,G23,G23,G23,G23,G23,G23,G23,G23,G33,S00,S00,S00
S00,S00,S00,S00,S00,S00,S00,S00,S00,S00,S00,G13,G55,G24H12H71,H22H81,H22H81,H22H81,H22H81,H22H81,H22H81,G24H32H91,G45,G33,S00,S00
S00,S00,S00,S00,S00,S00,S00,S00,S00,S00,S00,G14,G24,G24H14H73,H24H83,H24H83,H24H83,H24H83,H24H83,H24H83,G24H34H93,G24,G34,S00,S00
S00,S00,S00,S00,S00,S00,S00,S00,S00,S00,S00,G14,G24,G24H14H75,H24H85,H24H85,H24H85,H24H85,H24H85,H24H85,G24H34H95,G24,G34,S00,S00
S00,S00,S00,S00,S00,S00,S00,S00,S00,S00,S00,G14,G24,G24H16H77,H26H87,H26H20H87,H26H87,H26D50H87,H26H87,H26H20H87,G24H36H97,G24,G34,S00,S00
S00,S00,S00,S00,S00,S00,S00,S00,S00,S00,S00,G14,G24,G24H16,G24H26,G24H26D50,G24H26,G24H26,G24H26,G24H26,G24H36,G44,G35,S00,S00
S00,S00,S00,S00,S00,S00,S00,S00,S00,S00,S00,G14,G24,G24,G24,G24,G24,G24,G44,G25,G25,G35,S00,S00,S00
S00,S00,S00,S00,S00,S00,S00,S00,S00,S00,S00,G14,G24,G24,G24,G24,G24,G24,G34,S00,S00,S00,S00,S00,S00
S00,S00,S00,S00,S00,S00,S00,S00,S00,S00,S00,G14,G24,G24,G24,G24,G24,G24,G34,S00,S00,S00,S00,S00,S00
S00,S00,S00,S00,S00,S00,S00,S00,S00,S00,S00,G15,G54,G24,G24,G24,G24,G24,G34,S00,S00,S00,S00,S00,S00
S00,S00,S00,S00,S00,S00,S00,S00,S00,S00,S00,S00,G15,G25,G25,G25,G25,G25,G35,S00,S00,S00,S00,S00,S00
S00,S00,S00,S00,S00,S00,S00,S00,S00,S00,S00,S00,S00,S00,S00,S00,S00,S00,S00,S00,S00,S00,S00,S00,S00
S00,S00,S00,S00,S00,S00,S00,S00,S00,S00,S00,S00,S00,S00,S00,S00,S00,S00,S00,S00,S00,S00,S00,S00,S00
S00,S00,S00,S00,S00,S00,S00,S00,S00,S00,S00,S00,S00,S00,S00,S00,S00,S00,S00,S00,S00,S00,S00,S00,S00
S00,S00,S00,S00,S00,S00,S00,S00,S00,S00,S00,S00,S00,S00,S00,S00,S00,S00,S00,S00,S00,S00,S00,S00,S00
S00,S00,S00,S00,S00,S00,S00,S00,S00,S00,S00,S00,S00,S00,S00,S00,S00,S00,S00,S00,S00,S00,S00,S00,S00
S00,S00,S00,S00,S00,S00,S00,S00,S00,S00,S00,S00,S00,S00,S00,S00,S00,S00,S00,S00,S00,S00,S00,S00,S00
S00,S00,S00,S00,S00,S00,S00,S00,S00,S00,S00,S00,S00,S00,S00,S00,S00,S00,S00,S00,S00,S00,S00,S00,S00
S00,S00,S00,S00,S00,S00,S00,S00,S00,S00,S00,S00,S00,S00,S00,S00,S00,S00,S00,S00,S00,S00,S00,S00,S00
S00,S00,S00,S00,S00,S00,S00,S00,S00,S00,S00,S00,S00,S00,S00,S00,S00,S00,S00,S00,S00,S00,S00,S00,S00
S00,S00,S00,S00,S00,S00,S00,S00,S00,S00,S00,S00,S00,S00,S00,S00,S00,S00,S00,S00,S00,S00,S00,S00,S00
S00,S00,S00,S00,S00,S00,S00,S00,S00,S00,S00,S00,S00,S00,S00,S00,S00,S00,S00,S00,S00,S00,S00,S00,S00



