S00,S00,S00,S00,S00,S00,S00,S00,S00,S00,S00,S00,S00,S00,S00,S00,S00,S00,S00,S00,S00,S00,S00,S00,S00
S00,S00,S00,S00,S00,S00,S00,S00,S00,S00,S00,S00,S00,S00,S00,S00,S00,S00,S00,S00,S00,S00,S00,S00,S00
S00,S00,S00,S00,S00,S00,S00,S00,S00,S00,S00,S00,S00,S00,S00,S00,S00,S00,S00,S00,S00,S00,S00,S00,S00
S00,S00,S00,S00,S00,S00,S00,S00,S00,S00,S00,S00,S00,S00,S00,S00,S00,S00,S00,S00,S00,S00,S00,S00,S00
S00,S00,S00,S00,S00,S00,S00,S00,S00,S00,S00,S00,S00,S00,S00,S00,S00,S00,S00,S00,S00,S00,S00,S00,S00
S00,S00,S00,S00,S00,S00,S00,S00,S00,S00,S00,S00,S00,S00,S00,S00,S00,S00,S00,S00,S00,S00,S00,S00,S00
S00,S00,S00,S00,S00,S00,S00,S00,S00,S00,S00,S00,S00,S00,S00,S00,S00,S00,S00,S00,S00,S00,S00,S00,S00
S00,S00,S00,S00,S00,S00,S00,S00,S00,S00,S00,S00,S00,S00,S00,S00,S00,S00,S00,S00,S00,S00,S00,S00,S00
S00,S00,S00,S00,S00,S00,S00,S00,S00,S00,S00,S00,S00,S00,S00,S00,S00,S00,S00,S00,S00,S00,S00,S00,S00
S00,S00,S00,S00,S00,S00,S00,S00,S00,S00,S00,S00,S00,S00,S00,S00,S00,S00,S00,S00,S00,S00,S00,S00,S00
S00,S00,S00,S00,S00,S00,S00,S00,S00,S00,S00,S00,S00,S00,S00,S00,S00,S00,S00,S00,S00,S00,S00,S00,S00
S00,S00,S00,S00,S00,S00,S00,S00,S00,S00,S00,S00,S00,S00,S00,S00,S00,S00,S00,S00,S00,S00,S00,S00,S00
S00,S00,S00,S00,S00,S00,S00,S00,S00,S00,S00,S00,S00,S00,S00,S00,S00,S00,S00,S00,S00,S00,S00,S00,S00
S00,S00,S00,S00,S00,S00,S00,S00,S00,S00,S00,S00,S00,S00,S00,S00,S00,S00,S00,S00,S00,S00,S00,S00,S00
S00,S00,S00,S00,S00,S00,S00,S00,S00,S00,S00,S00,S00,S00,S00,S00,S00,S00,S00,S00,S00,S00,S00,S00,S00
S00,S00,S00,S00,S00,S00,S00,S00,S00,S00,S00,S00,T11,T31,S00,S00,S00,S00,S00,S00,S00,S00,S00,S00,S00
S00,S00,S00,S00,S00,S00,S00,S00,S00,S00,S00,S00,T13,T33,S00,S00,S00,S00,S00,S00,S00,S00,S00,S00,S00
S00,S00,S00,S00,S00,S00,S00,S00,S00,S00,S00,S00,T15,T35,S00,S00,S00,S00,S00,S00,S00,S00,S00,S00,S00
S00,S00,S00,S00,S00,S00,S00,S00,S00,S00,S00,S00,S00,S00,S00,S00,S00,S00,S00,S00,S00,S00,S00,S00,S00
S00,S00,S00,S00,S00,S00,S00,S00,S00,S00,S00,S00,S00,S00,S00,S00,S00,S00,S00,S00,S00,S00,S00,S00,S00
S00,S00,S00,S00,S00,S00,S00,S00,S00,S00,S00,S00,S00,S00,S00,S00,S00,S00,S00,S00,S00,S00,S00,S00,S00
S00,S00,S00,S00,S00,S00,S00,S00,S00,S00,S00,S00,S00,S00,S00,S00,S00,S00,S00,S00,S00,S00,S00,S00,S00
S00,S00,S00,S00,S00,S00,S00,S00,S00,S00,S00,S00,S00,S00,S00,S00,S00,S00,S00,S00,S00,S00,S00,S00,S00
S00,S00,S00,S00,S00,S00,S00,S00,S00,S00,S00,S00,S00,S00,S00,S00,S00,S00,S00,S00,S00,S00,S00,S00,S00
S00,S00,S00,S00,S00,S00,S00,S00,S00,S00,S00,S00,S00,S00,S00,S00,S00,S00,S00,S00,S00,S00,S00,S00,S00
S00,S00,S00,S00,S00,S00,S00,S00,S00,S00,S00,S00,S00,S00,S00,S00,S00,S00,S00,S00,S00,S00,S00,S00,S00
S00,S00,S00,S00,S00,S00,S00,S00,S00,S00,S00,S00,S00,S00,S00,S00,S00,S00,S00,S00,S00,S00,S00,S00,S00
S00,S00,S00,S00,S00,S00,S00,S00,S00,S00,S00,S00,S00,S00,S00,S00,S00,S00,S00,S00,S00,S00,S00,S00,S00
S00,S00,S00,S00,S00,S00,S00,S00,S00,S00,S00,S00,S00,S00,S00,S00,S00,S00,S00,S00,S00,S00,S00,S00,S00
S00,S00,S00,S00,S00,S00,S00,S00,S00,S00,S00,S00,S00,S00,S00,S00,S00,S00,S00,S00,S00,S00,S00,S00,S00