S00,S00,S00,S00,S00,S00,S00,S00,S00,S00,S00,S00,S00,S00,S00,S00,S00,S00,S00,S00,S00,S00,S00,S00,S00
S00,S00,S00,S00,S00,S00,S00,S00,S00,S00,S00,S00,S00,S00,S00,S00,S00,S00,S00,S00,S00,S00,S00,S00,S00
S00,S00,S00,S00,S00,S00,S00,S00,S00,S00,S00,S00,S00,S00,S00,S00,S00,S00,S00,S00,S00,S00,S00,S00,S00
S00,S00,S00,S00,S00,S00,S00,S00,S00,S00,S00,S00,S00,S00,S00,S00,S00,S00,S00,S00,S00,S00,S00,S00,S00
S00,S00,S00,S00,S00,S00,S00,S00,S00,S00,S00,S00,S00,S00,S00,S00,S00,S00,S00,S00,S00,S00,S00,S00,S00
S00,S00,S00,S00,S00,S00,S00,S00,S00,S00,S00,S00,S00,S00,S00,S00,S00,S00,S00,S00,S00,S00,S00,S00,S00
S00,S00,S00,S00,S00,S00,S00,S00,S00,S00,S00,S00,S00,S00,S00,S00,S00,S00,S00,S00,S00,S00,S00,S00,S00
S00,S00,S00,S00,S00,S00,S00,S00,S00,S00,S00,S00,S00,S00,S00,S00,S00,S00,S00,S00,S00,S00,S00,S00,S00
S00,S00,S00,S00,S00,S00,S00,S00,S00,S00,S00,S00,S00,S00,S00,S00,S00,S00,S00,S00,S00,B46,B56,S00,S00
S00,S00,S00,S00,S00,S00,S00,S00,S00,S00,S00,B13,S00,S00,S00,S00,S00,S00,S00,S00,B03,S00,S00,S00,S00
S00,S00,S00,S00,S00,S00,S00,S00,S00,S00,S00,M20,S00,S00,S00,S00,S00,S00,S00,S00,S00,B13,S00,S00,S00
S00,S00,S00,S00,S00,S00,S00,S00,S00,S00,S00,S00,S00,S00,S00,S00,S00,S00,S00,S00,S00,S00,S00,S00,S00
S00,S00,S00,S00,S00,S00,S00,S00,S00,S00,S00,S00,S00,S00,S00,S00,S00,S00,S00,S00,S00,S00,S00,S00,S00
S00,S00,S00,S00,S00,S00,S00,S00,S00,S00,S00,M33,S00,S00,S00,S00,S00,S00,S00,S00,S00,S00,S00,S00,S00
S00,S00,S00,S00,S00,S00,S00,S00,S00,S00,S00,M34,S00,S00,S00,P11,S00,P01,S00,S00,S00,S00,S00,S00,S00
S00,S00,S00,S00,S00,S00,S00,S00,S00,S00,S00,S00,T11,T31,S00,S00,P12,S00,P34,S00,S00,S00,S00,S00,S00
S00,S00,S00,S00,S00,S00,S00,S00,S00,S00,S00,S00,T13,T33,S00,B66,S00,S00,S00,S00,S00,S00,S00,S00,S00
S00,S00,S00,S00,S00,S00,S00,S00,S00,S00,S00,S00,T15,T35,S00,S00,S00,S00,S00,S00,S00,S00,S00,S00,S00
S00,S00,S00,S00,S00,S00,S00,S00,S00,S00,S00,S00,S00,S00,S00,S00,S00,S00,S00,S00,S00,S00,S00,S00,S00
S00,S00,S00,S00,S00,S00,S00,S00,S00,S00,S00,S00,S00,S00,S00,S00,S00,S00,S00,S00,S00,S00,S00,S00,S00
S00,S00,S00,S00,S00,S00,S00,S00,S00,S00,S00,S00,S00,S00,S00,S00,S00,S00,S00,S00,S00,S00,S00,S00,S00
S00,S00,S00,S00,S00,S00,S00,S00,S00,S00,S00,S00,S00,S00,S00,S00,S00,S00,S00,S00,S00,S00,S00,S00,S00
S00,S00,S00,S00,S00,S00,S00,S00,S00,S00,S00,S00,S00,S00,S00,S00,S00,S00,S00,S00,S00,S00,S00,S00,S00
S00,S00,S00,S00,S00,S00,S00,S00,S00,S00,S00,S00,S00,S00,S00,S00,S00,S00,S00,S00,S00,S00,S00,S00,S00
S00,S00,S00,S00,S00,S00,S00,S00,S00,S00,S00,S00,S00,S00,S00,S00,S00,S00,S00,S00,S00,S00,S00,S00,S00
S00,S00,S00,S00,S00,S00,S00,S00,S00,S00,S00,S00,S00,S00,S00,S00,S00,S00,S00,S00,S00,S00,S00,S00,S00
S00,S00,S00,S00,S00,S00,S00,S00,S00,S00,S00,S00,S00,S00,S00,S00,S00,S00,S00,S00,S00,S00,S00,S00,S00
S00,S00,S00,S00,S00,S00,S00,S00,S00,S00,S00,S00,S00,S00,S00,S00,S00,S00,S00,S00,S00,S00,S00,S00,S00
S00,S00,S00,S00,S00,S00,S00,S00,S00,S00,S00,S00,S00,S00,S00,S00,S00,S00,S00,S00,S00,S00,S00,S00,S00
S00,S00,S00,S00,S00,S00,S00,S00,S00,S00,S00,S00,S00,S00,S00,S00,S00,S00,S00,S00,S00,S00,S00,S00,S00